{
  "id": "demo",
  "name": "Demo Bitmask Level",
  "grid": {
    "cols": 12,
    "rows": 10
  },
  "contour": false,
  "layout": [
    "############",
    "#@         #",
    "# ### ###  #",
    "#   $   #  #",
    "# ###   #  #",
    "#       #  #",
    "# #####.#. #",
    "#       $  #",
    "#          #",
    "############"
  ]
}
